type octile
height 5
width 10
map
##########
..#...#...
#.#..##.##
#.......##
##########
